{
  "easy": {
    "maze": [
      ["🚪", ".", "🔳", ".", ".", ".", "🔳", "🔳", ".", ".", ".", "."],
      ["🔳", ".", "🔳", ".", ".", "🔳", "🔳", "🔳", ".", ".", "🔳", "."],
      [".", ".", "🔳", "🔳", "🔳", "🔳", ".", ".", ".", ".", "🔳", "🔳"],
      [".", ".", "🔳", "🔳", "🔳", ".", ".", "🔳", ".", ".", ".", "."],
      [".", ".", ".", ".", "🔳", ".", ".", "🔳", ".", ".", "🔳", "🏆"],
      [".", "🔳", "🔳", ".", "🔳", ".", "🔳", "🔳", ".", ".", ".", "🔳"],
      [".", "🔳", ".", ".", ".", ".", ".", ".", "🔳", "🔳", "🔳", "."],
      [".", ".", "🔳", ".", ".", ".", "🔳", "🔳", ".", ".", "🔳", "🔳"],
      [".", "🔳", ".", "🔳", "🔳", ".", "🔳", ".", ".", "🔳", "🔳", "."],
      [".", "🔳", ".", "🔳", ".", ".", "🔳", ".", "🔳", ".", ".", "🔳"],
      [".", ".", "🔳", ".", "🔳", ".", ".", "🔳", ".", "🔳", ".", "."],
      ["🔳", ".", ".", "🔳", "🔳", "🔳", ".", "🔳", "🔳", ".", "🔳", "."]
    ],
    "timer": 30
  },
  "intermediate": {
    "maze": [
      ["🚪", "🔳", "🔳", ".", "🔳", ".", "🔳", ".", "🔳", ".", ".", "."],
      [".", "🔳", ".", "🔳", "🔳", ".", "🔳", ".", "🔳", ".", "🔳", "."],
      [".", ".", ".", "🔳", "🔳", ".", "🔳", "🔳", "🔳", ".", "🔳", "."],
      ["🔳", "🔳", ".", "🔳", "🔳", ".", ".", "🔳", "🔳", ".", "🔳", "."],
      ["🔳", ".", ".", ".", "🔳", "🔳", "🔳", "🔳", "🔳", ".", "🔳", "🏆"],
      [".", ".", "🔳", ".", ".", "🔳", ".", ".", ".", ".", ".", "🔳"],
      [".", "🔳", "🔳", "🔳", ".", "🔳", ".", "🔳", ".", "🔳", ".", "."],
      [".", ".", ".", ".", ".", "🔳", ".", ".", "🔳", ".", "🔳", "."],
      ["🔳", "🔳", "🔳", ".", "🔳", "🔳", ".", "🔳", ".", ".", ".", "."],
      [".", ".", "🔳", ".", "🔳", "🔳", ".", "🔳", "🔳", "🔳", "🔳", "🔳"],
      [".", ".", "🔳", ".", ".", ".", ".", "🔳", "🔳", "🔳", ".", "."],
      ["🔳", "🔳", ".", "🔳", "🔳", "🔳", ".", "🔳", "🔳", ".", ".", "🔳"]
    ],
    "timer": 20
  },
  "hard": {
    "maze": [
      ["🚪", ".", "🔳", "🔳", "🔳", "🔳", "🔳", ".", ".", ".", ".", "🔳"],
      [".", "🔳", ".", "🔳", ".", ".", "🔳", ".", ".", "🔳", ".", "🏆"],
      [".", ".", ".", ".", "🔳", "🔳", ".", ".", ".", "🔳", "🔳", "🔳"],
      [".", ".", ".", ".", ".", ".", "🔳", "🔳", ".", ".", ".", "."],
      ["🔳", "🔳", "🔳", ".", "🔳", "🔳", ".", "🔳", ".", "🔳", "🔳", "."],
      ["🔳", ".", "🔳", ".", ".", ".", ".", ".", ".", "🔳", ".", "🔳"],
      [".", ".", "🔳", ".", "🔳", "🔳", ".", "🔳", ".", ".", "🔳", "🔳"],
      [".", ".", ".", ".", "🔳", "🔳", "🔳", ".", ".", "🔳", ".", "."],
      [".", ".", ".", ".", ".", "🔳", "🔳", ".", ".", "🔳", "🔳", "🔳"],
      [".", ".", "🔳", ".", "🔳", "🔳", ".", ".", "🔳", "🔳", ".", "."],
      [".", ".", "🔳", ".", ".", ".", ".", "🔳", ".", "🔳", "🔳", "🔳"],
      [".", ".", "🔳", ".", "🔳", ".", "🔳", ".", "🔳", ".", "🔳", "."]
    ],
    "timer": 15
  }
}
